IOT|Internet of Things|3|IoT protocols, cloud connectivity|Dr.Nouran Samir|EMB
AI|Artificial Intelligence|3|AI concepts and search algorithms|Dr. Aya Kamel|ALG
ALG|Algorithms|4|Sorting, Searching, Dynamic Programming|Dr. Mariam Ayman|DS
APP|Mobile App Development|3|Android/iOS development fundamentals|Dr. Amr Saeed|WEB
BLOCK|Blockchain Technology|3|Decentralized systems and smart contracts|Dr. Rasha Seif|DB
AR|Augmented Reality|3|ARKit, ARCore, spatial mapping|Dr. Salma Yehia|APP
BIGDATA|Big Data Analytics|4|Hadoop, Spark, large-scale data|Dr. Khaled Morsy|DB
OOP|Object-Oriented Programming|3|OOP principles using Java|Dr. Reem Youssef|PRG
ARCH|Computer Architecture|3|Digital logic and system architecture|Dr. Samir Elmasry|PRG
SWE|Software Engineering|3|Software lifecycle, UML, testing|Dr. Eman Lotfy|OOP
CLOUD|Cloud Computing|3|Cloud models and architecture|Dr. Sarah Nasser|NET
QUANT|Quantum Computing|3|Qubits, gates, and algorithms|Dr. Hany Farid|ALG
CV|Computer Vision|3|Image classification, object detection|Dr. Basel Ali|ML
DB|Database Systems|3|SQL, ER diagrams, indexing|Dr. Omar Hassan|DS
NET|Computer Networks|3|OSI model, TCP/IP, networking protocols|Dr. Khaled Anwar|ARCH
DEVOPS|DevOps Engineering|3|CI/CD, Docker, Kubernetes|Dr. Amina Raouf|WEB
PRG|Introduction to Programming|3|Basics of programming using C++|Dr. Ahmed Salem|
DS|Data Structures|4|Stacks, Queues, Trees, Hashing|Dr. Nabil Fathy|OOP
EMB|Embedded Systems|3|Microcontrollers and real-time systems|Dr. Mona Galal|ARCH
GRAPH|Computer Graphics|3|Rendering, OpenGL, modeling|Dr. Hesham Gamil|DS
GAME|Game Development|3|Unity, game loops, physics|Dr. Karim Maher|WEB
HACK|Ethical Hacking|3|Penetration testing, tools, vulnerabilities|Dr. Heba Gamil|SEC
HCI|Human-Computer Interaction|3|UX/UI design, evaluation techniques|Dr. Layla Naguib|SWE
IMG|Digital Image Processing|3|Filters, transformations, feature extraction|Dr. Youssef Nasr|GRAPH
IR|Information Retrieval|3|Search engines, indexing, ranking|Dr. Mahmoud Fadel|DB
ML|Machine Learning|3|Supervised & Unsupervised Learning|Dr. Waleed Gabr|AI
NLP|Natural Language Processing|3|Text processing and language models|Dr. Yasmine Adel|ML
OS|Operating Systems|4|Processes, Threads, Memory Management|Dr. Dina Helmy|DS
PARA|Parallel Programming|4|Multi-threading, OpenMP, CUDA|Dr. Mostafa Abouzeid|ALG
SEC|Cybersecurity|3|Network security, encryption, attacks|Dr. Lamiaa Hamdy|NET
WEB|Web Development|3|Frontend & Backend basics|Dr. Rania Farouk|OOP
